WWWWWWWWWWWWWWWW
W·····WWW······W
W·C····WW·G····W
W·B·····W······W
W··············W
W·B··········B·W
W·G·······WWWWBW
W·········W····W
W·········W····W
W·········W···GW
WWWWWWWWWWWWWWWW
