WWWWWW
W·B·GW
W·C··W
W··BGW
WWWWWW
