WWWWWWWWWWWWWWWW
W·····WWW······W
W·C····WW·X····W
W·······W······W
W··············W
W··············W
W·X·······WWWW·W
W·········W····W
W·········W····W
W·········W···XW
WWWWWWWWWWWWWWWW
