WWWWWWWWWWWWWWWW
W·····WWW······W
W······WW·X····W
W·······W······W
W··············W
W··············W
W·X·······WWWW·W
W·········W····W
W·········W···CW
W·········W···XW
WWWWWWWWWWWWWWWW
