WWWWWWWWW
W····G·WW
WC···B··W
W······WW
WWWWWWWWW
