WWWWWWWWWWWWW
W········W··W
W·B··W···B··W
WW·WWWWWWW·WW
W··BCW···W··W
W···B····W··W
WWBWWWW··W··W
WGXGW··BWWBWW
WGGG··W·B···W
WGGG····W···W
WWWWWWWWWWWWW