WWWWWWWWW
W··B·G·WW
WC···B··W
W······WW
WWWWWWWWW
